{
  "id": "gap-and-platforms",
  "cols": 20,
  "rows": 12,
  "grid": [
    "....................",
    "....................",
    "....................",
    "....................",
    "....................",
    ".........GGGG.......",
    "....................",
    "....................",
    "..GGGG.........GGGG.",
    "....................",
    ".............H......",
    "GGGGGGGG...GGGGGGGGG"
  ],
  "entities": []
}
