{
  "id": "section-piri",
  "cols": 60,
  "rows": 12,
  "grid": [
    "............................................................",
    "............................................................",
    "............................................................",
    "............................................................",
    "............................................................",
    ".........................G........G.........................",
    "........................G...G....G............GG............",
    ".......................G.....G..............G....G......G...",
    "......GG...........GGGG.........G..G.......G......G....G..G.",
    "..........G.......G............G.......GGGG.........G......G",
    "...GGG...........G..................G.G..............G......",
    "G.............GGG....................G......................"
  ],
  "bgGrid": [
    "............................................................",
    "............................................................",
    "............................................................",
    "............................................................",
    "............................................................",
    "............................................................",
    "............................................................",
    "............................................................",
    "............................................................",
    "............................................................",
    "............................................................",
    "............................................................"
  ],
  "entities": [],
  "tileStyles": {
    "G": {
      "color": "#4a4a5e"
    },
    "H": {
      "color": "#d1495b"
    },
    "B": {
      "color": "#2e3a4a"
    }
  }
}
