{
  "id": "section-60",
  "cols": 60,
  "rows": 12,
  "grid": [
    "............................................................",
    "............................................................",
    "............................................................",
    "............................................................",
    "............................................................",
    "............................................................",
    "..................G.........................................",
    "................G.G....................GG...................",
    "...............GG.GG............GG..GG.GG...............G...",
    "...............GG.GGG........GG.GG..GG.................GGG..",
    ".............GGGG.GGGGG...GG.GG.............GG........GGGGG.",
    "GGG..GGGGG..GGGGG.GGGGG...GG................GGGGGGGGGGGGGGGG"
  ],
  "entities": []
}
