{
  "id": "section-greenOldSwampy",
  "cols": 60,
  "rows": 12,
  "grid": [
    "............................................................",
    "...........................G................................",
    "...........................G...........................GGGGG",
    "...........................G.G........................GG....",
    "...........................G...G....GG.....G.........GG.....",
    "..........................GG.....G.......G...G......GG......",
    "..........................GG...........G.......GGGGG........",
    "..................G.......G.................................",
    "................GG.......GG.................................",
    ".............GGG.........GG.................................",
    ".........GGGG...........GGG.................................",
    "GGG.GGGG...............GGG.................................."
  ],
  "bgGrid": [
    "............................................................",
    "............................................................",
    "............................................................",
    "............................................................",
    "............................................................",
    "............................................................",
    "............................................................",
    "............................................................",
    "............................................................",
    "............................................................",
    "............................................................",
    "............................................................"
  ],
  "entities": [],
  "tileStyles": {
    "1": {
      "color": "#2e3a4a"
    },
    "G": {
      "color": "#33d17a"
    },
    "H": {
      "color": "#d1495b"
    },
    "B": {
      "color": "#62a0ea"
    }
  }
}
