{
  "id": "section-c",
  "cols": 60,
  "rows": 30,
  "grid": [
    "............................................................",
    "............................................................",
    "............................................................",
    "............................................................",
    "............................................................",
    "............................................................",
    "............................................................",
    "............................................................",
    "............................................................",
    "............................................................",
    "............................................................",
    "............................................................",
    "............................................................",
    "............................................................",
    "............................................................",
    "............................................................",
    "............................................................",
    "............................................................",
    "............................................................",
    "............................................................",
    "............................................................",
    "............................................................",
    "............................................................",
    ".................G..............G............GG.............",
    "...G........GG...............GG..G..........G...............",
    "...........................G......G........G....G...........",
    ".........GG........G................GG.GG.G......G.GG..G....",
    "........G....GG.G......G.G...........................GG..H..",
    "....G..G..............G..................................G..",
    "GG................GGGG....................................GG"
  ],
  "bgGrid": [
    "............................................................",
    "............................................................",
    "............................................................",
    "............................................................",
    "............................................................",
    "............................................................",
    "............................................................",
    "............................................................",
    "............................................................",
    "............................................................",
    "............................................................",
    "............................................................",
    "............................................................",
    "............................................................",
    "............................................................",
    "............................................................",
    "............................................................",
    "............................................................",
    "............................................................",
    "............................................................",
    "............................................................",
    "............................................................",
    "............................................................",
    "............................................................",
    "............................................................",
    "............................................................",
    "............................................................",
    "............................................................",
    "............................................................",
    "............................................................"
  ],
  "entities": [],
  "tileStyles": {
    "G": {
      "color": "#4a4a5e"
    },
    "H": {
      "color": "#d1495b"
    },
    "B": {
      "color": "#2e3a4a"
    }
  }
}
