{
  "id": "section-bootybootbootboot",
  "cols": 60,
  "rows": 12,
  "grid": [
    "............................................................",
    "............................................................",
    "..............GGGG...........G..............................",
    "..............G...G.........GG..............................",
    ".............G......GG....GG................................",
    "...........GG..........GG..........G..........G.............",
    "..........G............GG.......GG..GGG.....GG..G...........",
    "..........G...................G.........GG.................G",
    ".........G................GGG.............G......G........G.",
    ".......GG...............................................G...",
    "....GGG.....................................................",
    "GGGG..............................................G.G.G....."
  ],
  "bgGrid": [
    "............................................................",
    "............................................................",
    "............................................................",
    "............................................................",
    "............................................................",
    "............................................................",
    "............................................................",
    "............................................................",
    "............................................................",
    "............................................................",
    "............................................................",
    "............................................................"
  ],
  "entities": [
    {
      "type": "enemyFalseFriend",
      "col": 59,
      "row": 6
    }
  ],
  "tileStyles": {
    "G": {
      "color": "#4a4a5e"
    },
    "H": {
      "color": "#d1495b"
    },
    "B": {
      "color": "#62a0ea"
    }
  }
}
