{
  "id": "section-kkk",
  "cols": 60,
  "rows": 12,
  "grid": [
    "............................................................",
    "......................................................G.....",
    ".....................................................G.G....",
    ".....................................................G..G...",
    ".....................................................G...G..",
    "....................................................G....G..",
    ".......................GGGG.........................G....G..",
    ".....G....GG.......GG......GGGG....................G......G.",
    ".......GG....G..GG.............G.................GG........G",
    "....G...........................GGG...........GGG...........",
    ".G.................................G.....H.GGG..............",
    "G...................................GGGHHH.................."
  ],
  "bgGrid": [
    "............................................................",
    "............................................................",
    "............................................................",
    "............................................................",
    "............................................................",
    "............................................................",
    "............................................................",
    "............................................................",
    "............................................................",
    "............................................................",
    "............................................................",
    "............................................................"
  ],
  "entities": [],
  "tileStyles": {
    "G": {
      "color": "#4a4a5e"
    },
    "H": {
      "color": "#d1495b"
    },
    "B": {
      "color": "#2e3a4a"
    }
  }
}
