{
  "id": "stupid",
  "cols": 60,
  "rows": 12,
  "grid": [
    "............................................................",
    "............................................................",
    "............................................................",
    "............................................................",
    "............................................................",
    "............................................................",
    "............................................................",
    "............................................................",
    "............................................................",
    "............................................................",
    "............................................................",
    "GGGGGG....GGGGGGGG.........................................."
  ],
  "bgGrid": [
    "............................................................",
    "............................................................",
    ".....BBBBBB.................................................",
    ".....B.....BBB..............................................",
    "BBBBBBBBBBBBBBBBBB.BB.......................................",
    "BBBBBBBBBBBBBBBBBBBBBBBB....................................",
    "BBBBBBBBBBBBBBBBBB..........................................",
    "BBBBBBBBBBBBBBBBBBBBBBB.....................................",
    "BBBBBBBBBBBBBBBB.BBBBBBBBBBBB...............................",
    "BBBBBBBBBBBBBBBBBBBBBBBBBBBB................................",
    "BBBBBBBBBBBBBBBBBBBBBBBBBBBB................................",
    "BBBBBBBBBBBBBBBBBB.BB.BB...................................."
  ],
  "entities": [
    {
      "type": "playerSpawn",
      "col": 0,
      "row": 10
    },
    {
      "type": "goal",
      "col": 16,
      "row": 10
    }
  ],
  "tileStyles": {
    "1": {
      "texture": "monkatest"
    },
    "2": {
      "color": "#2e3a4a"
    },
    "3": {
      "texture": "monkatest"
    },
    "4": {
      "texture": "monkatest"
    },
    "G": {
      "color": "#4a4a5e"
    },
    "H": {
      "color": "#d1495b"
    },
    "B": {
      "texture": "monkatest"
    }
  }
}
